111111111111111
100110C11001111
100000000011001
10P010000110001
10111000C000001
1001001111000E1
111111111111111
